NO ./textures/north.xpm
SO ./textures/south.xpm
WE ./textures/west.xpm
EA ./textures/east.xpm
F 20,20,20
C 200,200,255
11111
1N001
11111
